R 640 480
SO ./textures/north.xpm
NO ./textures/south.xpm
WE ./textures/west.xpm
EA ./textures/west.xpm

S ./textures/borat.xpm
F 0,0,0
C 0,0,0

        1111111111111111111111111
        1000000000110000001000001
        1011000001110000000000001
        1001000000000000100010001
111111111011000001110000000000001
1 1110000011000001110111101011111
11110111111111011100000010001
11110111111111011101010010001
11000000110101011100000010201
10020002020000000000000000001
10000000000000001101010000001
11000001110101011111011220201
11000111 1110101 10000N000011
 1111111 1111111 111111111111
