R 1920 1080

NO ./textures/4.xpm
SO ./textures/2.xpm
WE ./textures/3.xpm
EA ./textures/1.xpm

S ./textures/pepega.xpm
F 143,254,9
C 243,9,254

111111111111111111111111111111111
100000001000000000110000000000001
100000001011000001110000002000001
100000001001000000000000000000001
111111111011000001110000000000001
100000000011000001110111111111111
111101111111110111000000100011111
111101111111110111010100100011111
110000001101010111000000100011111
100020000000000011000000100011111
100000000000000011010100100011111
11000001110101011111011110N011111
111101110111010101011110100011111
111111111111111111111111111111111
