R 1920 1080

NO ./textures/4.xpm
SO ./textures/2.xpm
WE ./textures/3.xpm
EA ./textures/1.xpm

S ./textures/pepega.xpm
F 143,254,9
C 243,9,254

111111111111111111111111111111111111
100000000001000100011000001000100011
121111100100010001010011100010001001
110000000101111101001010001111101111
100101110111000100001000000000000001
101101000100011111101010111111111111
111001010001010000000010000100000001
110001111111110110110110010110111101
11001100000011001S100100100000000001
111001011110110101101001111111111101
101101010000010100000010000101000001
100101010111110101111110101001010111
110100010100010110000010100000000001
100101110001010000111011101111110101
101100011100011010101000001000010001
100001000001000010000011011011000121
111111111111111111111111111111111111
