R 1280 720

NO ./textures/4.xpm
SO ./textures/2.xpm
WE ./textures/3.xpm
EA ./textures/1.xpm

S ./textures/pepega.xpm
F 143,254,9
C 243,9,254

1 1 1 1 1 1 1 1 1 1 1 1 1 1 1 1 1 1 1 1 1 1 1 1 1 1 1 1 1
1 0 1 0 1 0 1 0 1 0 1 0 1 0 1 0 1 0 1 0 1 0 1 0 1 0 1 0 1
1 0 0 0 0 0 0 0 0 0 0 0 0 0 0 0 0 0 0 0 0 0 0 0 0 0 0 0 1
1 0 1 0 1 1 0 0 0 0 0 0 0 0 0 0 0 0 0 0 1 0 1 0 1 0 1 1 1
1 0 1 0 0 0 0 2 2 2 2 2 2 2 2 2 2 2 0 0 0 1 0 1 0 0 0 0 1
1 0 0 0 1 1 0 1 0 0 0 0 0 0 0 2 0 0 2 2 0 0 0 0 0 0 1 1 1
1 0 1 0 0 1 0 0 0 0 0 0 0 0 2 0 0 W 0 0 2 0 0 0 0 0 0 0 1
1 0 1 0 0 0 0 0 0 1 0 1 0 0 2 0 0 0 0 0 2 0 1 0 1 0 1 1 1
1 0 0 0 0 0 0 0 0 0 0 0 0 0 0 2 0 0 2 2 0 0 0 0 0 0 0 0 1
1 0 0 0 0 0 2 0 0 2 2 2 2 2 2 2 2 2 0 0 0 0 0 0 0 0 1 1 1
1 0 1 0 0 2 0 1 2 2 0 0 0 0 0 0 0 0 0 0 0 0 0 0 0 0 0 0 1
1 0 1 0 2 0 0 0 2 0 2 0 1 0 1 0 1 0 1 0 1 0 1 0 1 0 1 1 1
1 0 1 0 0 2 0 0 2 0 2 0 0 0 0 0 0 0 0 0 0 0 0 0 1 0 0 0 1
1 1 1 1 1 1 1 1 1 1 1 1 1 1 1 1 1 1 1 1 1 1 1 1 1 1 1 1 1
