11111111111111111111
1000000000000000000111111111111111111
1000000000N00000000000000000000000011
1000000000000000000111111111111111111
10000000000000000001
10000000000000000001
11111111111111111111
